1111111111111
1001000000011
1000001111011
1P001100E0C01
1111111111111
