111111
1E0001
100001
1P11C1
111111
