111111
1E0011
100001
1P11C1
111111
